%%%%%%%%%%%%%%%%%%%%
%   P..%    %......%
% %%...%%  %%...%%.%
% %o %........%.o%.%
% %%.%.%%%%%%.%.%%.%
%         .........%
%%%%%%%%%%%%%%%%%%%%