%%%%%%%%%%%%%%%%%%%%
%      %    %      %
% %%   %%  %%   %% %
% %  %        %Po% %
% %% % %%%%%% %.%% %
%                  %
%%%%%%%%%%%%%%%%%%%%